22222222222222222222222
20000000002000000000002
20111111002001111000002
20000001002000001022222
22222201002000201000002
20000001002000201000002
20111111002000201111102
20000001002222201000002
22222201002000001000002
20000201002011111111102
20010201002010000000002
20010001000010022222222
20010001000010000000002
20011111111111111111102
20000000000000000000002
22222222222222222222222